1111111110111111111
1000001100110010001
1011100101001000101
1000111101010111001
1101000001010100101
1101011111000011111
1001001001011000001
1101101100011101011
1001000001001001001
1011101111101111101
1001000100001100101
1101011010100110101
1000111001110000011
1001110010111101001
1100100110000100111
1001010111110000001
1010010101100101101
1010100100010001001
1010110101010101101
1100000001000100001
1001010100010010101
1100010101001011101
1001010101101000011
1010010100101111011
1010100101111000011
1001101100001001001
1101000101101101101
1001110101001000101
1111000111010110101
1101110111010000101
1000000000010110101
1011111101010100101
1010010000111010001
1010111110001001101
1000000001101100001
1011111100000111101
1010000101101000101
1011110110101010101
1000000000000010001
1011111111111111111